영상음향기기 -> 헤드셋
컴퓨터 + 컴퓨터수리비
휴대용멀티미디어기기 pass
컴퓨터소모품 -> 그래픽카드
저장장치 -> usb
헬스기구 -> 런닝머신
레저용품 pass
운동용품 pass
원예용품 -> 원예
반려동물용품 + 반려동물관리비
수영장이용료 -> 수영장
헬스클럽이용료 -> 헬스장
골프장이용료 + 골프연습장이용료
당구장이용료 -> 당구장
노래방이용료 -> 노래방
pc방이용료 -> pc방
운동경기관람료 -> 야구장
공연예술관람료 -> 공연
관람시설이용료 -> 전시
독서실비 -> 스터디카페
문화강습료 -> 문화센터
온라인콘텐츠이용료 -> ott
방송수신료 -> 수신료
사진서비스료 -> 사진관
(초+중+고) 학습서
대학교재 pass
서적 -> 책
종이문구, 기타문구, 필기구, 회화용구 pass
국내단체여행비 -> 국내여행
해외단체여행비 -> 해외여행
대학등록금 모음
학원비 모음
가정학습지 -> 학습지
외국어학원 -> 영어학원
김치찌개백반 -> 김치찌개
된장찌개백반 -> 된장찌개
(외식) 붙은건 떼기